R 1000 1000
NO ./textures/stone.xpm
SO ./textures/stone.xpm
WE ./textures/stone.xpm
EA ./textures/stone.xpm
S ./textures/stone.xpm
F 220,100,0
C 225,30,0


11111
1WW01
10001
11111
